TTTTTTTTTTTTTTTTTTTTTTTT
T  P  T  R         R   T
T  R   T       P   TT PT
T    PT     P TTTTTT     .
T  P  TTTTTTT      T   T
T P         T PTT      T
TTTTT   R   T  T  TTT  T
T      RTTTTTT   TTT   T
T TTT   T    P     T   T
T T   P T  T       TTTTT
TPT P      TT          T
T     P  T T T      P  T
TTTTTTTTTTTTTTTTTTTTTTTT